22222222222222222222
21111211111111121112
21222121222222121212
21112121100211121112
22212121222222121222
21111111111111111112
21222122222222122212
21111111221111111112
22221222000022212222
21111211122111211112
21222221222222122212
21111111111111111112
22222222222222222222
